{
  "A1":
  {
    "A1": "A1",
    "A2": "A2",
    "A3": "A3",
    "A4": "A4",
    "A5": "A5",
    "A6": "A6",

    "B1": "A7",
    "B2": "A8",
    "B3": "A9",
    "B4": "A10",
    "B5": "A11",
    "B6": "A12",

    "C1": "B1",
    "C2": "B2",
    "C3": "B3",
    "C4": "B4",
    "C5": "B5",
    "C6": "B6",

    "D1": "B7",
    "D2": "B8",
    "D3": "B9",
    "D4": "B10",
    "D5": "B11",
    "D6": "B12"
  },
  "A2":
  {
    "A1": "C1",
    "A2": "C2",
    "A3": "C3",
    "A4": "C4",
    "A5": "C5",
    "A6": "C6",

    "B1": "C7",
    "B2": "C8",
    "B3": "C9",
    "B4": "C10",
    "B5": "C11",
    "B6": "C12",

    "C1": "D1",
    "C2": "D2",
    "C3": "D3",
    "C4": "D4",
    "C5": "D5",
    "C6": "D6",

    "D1": "D7",
    "D2": "D8",
    "D3": "D9",
    "D4": "D10",
    "D5": "D11",
    "D6": "D12"
  },
  "A3":
  {
    "A1": "E1",
    "A2": "E2",
    "A3": "E3",
    "A4": "E4",
    "A5": "E5",
    "A6": "E6",

    "B1": "E7",
    "B2": "E8",
    "B3": "E9",
    "B4": "E10",
    "B5": "E11",
    "B6": "E12",

    "C1": "F1",
    "C2": "F2",
    "C3": "F3",
    "C4": "F4",
    "C5": "F5",
    "C6": "F6",

    "D1": "F7",
    "D2": "F8",
    "D3": "F9",
    "D4": "F10",
    "D5": "F11",
    "D6": "F12"
  },
  "A4":
  {
    "A1": "G1",
    "A2": "G2",
    "A3": "G3",
    "A4": "G4",
    "A5": "G5",
    "A6": "G6",

    "B1": "G7",
    "B2": "G8",
    "B3": "G9",
    "B4": "G10",
    "B5": "G11",
    "B6": "G12",

    "C1": "H1",
    "C2": "H2",
    "C3": "H3",
    "C4": "H4",
    "C5": "H5",
    "C6": "H6",

    "D1": "H7",
    "D2": "H8",
    "D3": "H9",
    "D4": "H10",
    "D5": "H11",
    "D6": "H12"
  }
}
